1111111111111
1CCC0C00000C1
10X0CC0C0E001
1PC000000C0C1
1000000000001
1000000000001
10X0000X00001
1000X00000001
1111111111111
